wwwwwwwwwwwwwwwwwwwwwwwww
w po                    w
w                       w
w                       w
w                       w
w                       w
w                       w
w                       w
w                       w
w                       w
w                       w
w                       w
w                       w
w                       w
w                       w
w                       w
w                    g  w
w                       w
w                       w
wwwwwwwwwwwwwwwwwwwwwwwww